**************************
*S                       *
** ********************* *
*  ******** **** **    * *
* **    ***         **** *
* ***** **  ************ *
*     * ** ******      * *
** ** * ** *      **** * *
*  **   ** * **** *    * *
* **** *** ***    ****** *
* ****      ***** ****** *
*      **********  ***** *
* ********* ******     * *
* ********* ****** ***** *
*                        *
********************* ****
*                       T*
**************************

