**********
*S* **   *
*      * *
* **** * *
*   **** *
*** *T   *
**********