**********
*S* **   *
*      ***
* **** * *
*   **** *
*** *T   *
**********