S **********************************   ************
* ***       **       ***          ** **** ****    *
*     ***** ** * *** *   ******** **        *  ** *
* ********* **** **    *****    * ********* ***** *
*       ***      ** ***** *  ** * *********       *
******* **  ************* ****  * ********* *******
*     * ** ******      **      **           *     *
* *** * ** *      ******* ******* *********** *** *
* ***   ** * **** *               *** ******* *****
* ******** ***    ******* ******* *               *
* ****      *****         ******* *************** *
*      **** *********************     *********** *
*********** ******              ***** ***  *  *** *
*       *** *      ************ ***** *** *** *** *
* *****     * *** ****       ** ***** *           *
* **  ***** * *** *  * *** ***      * ***** * *****
*    **   * *   *   ** *T********** * ******* *****
**** *  * * *** * ***  *            *         *****
*  * **** * *** *  ** **************** ******     *
* ** *    * *** ** ** *** *            ********** *
*    * ******** *         * ********************* *
**** * *        ***********          ***********  *
**** * ********             ********          ** **
*    *   *************************************** **
* ****** *** ****                                **
* *      *     ** ********** **********************
*   ****** ****** ** ******* *                   **
** ******* ****** *          ***** ************* **
**                *** ******       **             *
***************************************************
